alie: otherwise
ambulanco: field hospital
artefarita: artificial
artefarite: artificially
aviadilo: airplane
boksaĵo: boxing match
bonfaranto: benefactor
ĉambro-robo: dressing-gown
disvastigita: widespread
duonigita: bisected
ekflamigita: kindled
eligi: to emit
elreviĝa: disappointing
estonta: future
estonto: future
funebraĵo: funeral
funebristo: mortician
garbejo: barn
ĝustatempigi: to well-time
klarigo: explanation
kompataĉinda: pitiful
konstruaĵo: building
kreaĵo: creature
kulpigi: to blame
malfruo: delay
pied-pinte: tiptoed
registaro: government
sepultejo: sepulcher
specialigita: specialized
stabejo: military headquarters
tagiĝo: dawn
tiel-nomata: so-called
tim-sensentigi: to chill
transigita: committed
ungo-mortigita: clawed to death
ventro-parolade: ventriloquistically
ventro-parolado: ventriloquism
volontula: volunteer
zorgato: ward